# # # # # # # #
# - # - - - - #
# - # - # - - #
# - # - - - - #
# - - - - # - #
# - - - # - - #
# - - - - - - #
# # # # # # # #